{
  "name": "Maze 1 Easy",
  "size": 9,
  "grid": [
    "#########",
    "#S......#",
    "#.#####.#",
    "#.....#.#",
    "#.###.#.#",
    "#...#...#",
    "###.#..##",
    "#....#.G#",
    "#########"
  ],
  "legend": {
    "#": "wall",
    ".": "floor",
    "S": "start",
    "G": "goal"
  }
}
