{
  "name": "Maze 2 Medium",
  "size": 11,
  "grid": [
    "###########",
    "#S..#.....#",
    "#.#.#.###.#",
    "#.#...#...#",
    "#.###.#.#.#",
    "#...#.#.#.#",
    "###.#.#.#.#",
    "#...#...#.#",
    "#.#####.#.#",
    "#.......#G#",
    "###########"
  ],
  "legend": {
    "#": "wall",
    ".": "floor",
    "S": "start",
    "G": "goal"
  }
}
